%%%%%%%%%%%%
%..%     PP%
%..%     PP%
%..   %%%  %
%..   %%%  %
%%%%%%%%%%%%