%%%%%%%%%%%%
%..%..   PP%
%..%..   PP%
%.. ..%%%  %
%.. ..%%%  %
%%%%%%%%%%%%