%%%%%%%%%%%%
%..%     PP%
%..%     PP%
%     %%%  %
%     %%%  %
%%%%%%%%%%%%