%%%%%%%%%%%%%%
%. . . . . % %
%          % %
%. . . . . %G%
%          % %
%. . . . . % %
%          % %
%. . P . . % %
%          %G%
%. . . . . % %
%          % %
%. . . . . % %
%          % %
%%%%%%%%%%%%%%
