%%%%%%%%%%%%%%%%
%..PP        GG%
%..PP        GG%
%  %%..%%GG%%%%%
%  %%..%%GG%%%%%
%GG        %%%%%
%GG        %%%%%
%%%%%%%%%%%%%%%%