%%%%%%%%%%%%%%%%%%%%
%..................%
%    %%      %%....%
%....%%  %%  %%....%
% .  %%  o   %%  . %
% .  %%      %%  . %
%                  %
% .  %%      %%  . %
% .  %%  G   %%  . %
% .  %%%%%%%%%%  . %
% P  .........     %
% %%%%%%  o %%%%%% %
%                  %
% ..%  . %% .  %.. %
% ..%  . %% .  %.. %
% %%%  . %% .  %%% %
%                  %
% .. %%%%%%%%%% .. %
% ...... G ....... %
%%%%%%%%%%%%%%%%%%%%