%%%%%%%
%  P  %
%     %
%     %
%     %
%     %
%  .  %
%     %
%%%%%%%