%%%%%%%%%%%%%%%%%%%%%%%%%%%%%%%%%%%%%%
%......%%..................%%%%......%
%......%%..................%%%%......%
%..%%..%%..%%%%%%%%%%%%%%%%%%%%..%%..%
%..%%..%%..%%%%%%%%%%%%%%%%%%%%..%%..%
%....................................%
%....................................%
%%%%%%%%%%%%%%%..%%..%%%%%%%%%%%%%%PP%
%%%%%%%%%%%%%%%..%%..%%%%%%%%%%%%%%PP%
%%%%%%%%%%%%%%%..............        %
%%%%%%%%%%%%%%%..............        %
%%%%%%%%%%%%%%%%%%%%%%%%%%%%%%%%%%%%%%