%%%%%%%%
%..PP  %
%..PP  %
%%%%%  %
%..    %
%..    %
%%%%%%%%
