%%%%%%%%%%%%%%
%      PP  GG%
%      PP  GG%
%GG%%%%%%%%%%%
%GG          %
%........    %
%........    %
%%%%%%%%%%%%%%
